111111121111111111111111111
100010001000100000000000001
101010111010101111111111101
101010100010101000100000101
101010111110101010111110101
101000100000101010100010101
111110101111101010101010101
100000100000001010101000101
101111111111101010101111101
101000001000101010001100101
101011111010101010111010101
101010000010100010100010101
101010111010111110101110101
101000100010100000101000101
101110101011101111101111101
101010101000001000100010001
101010111111111010111011101
101010001000100010101000000
101010101010111110101111101
100000100010000000100000001
111111111111111111111111111
